10 15
8 0
1 1 1 1 1 1 1 1 1 1 1 1 1 1 1
2 0 0 0 2 0 0 0 0 2 0 0 0 0 2
2 0 2 0 2 2 2 2 2 2 2 0 2 0 2
2 0 2 0 0 0 0 0 0 0 0 0 2 0 2
2 0 2 2 2 2 2 2 2 2 0 0 2 0 2
2 0 0 0 0 0 0 0 0 2 2 2 2 0 6
2 2 2 2 2 2 0 0 0 0 0 0 2 2 2
2 0 0 0 0 2 2 2 2 2 2 0 0 0 2
0 0 0 0 0 0 0 0 0 0 0 0 0 0 2
3 3 3 3 3 3 3 3 3 3 3 3 3 3 3