10 15
3 0
1 1 1 1 1 1 1 1 1 1 1 1 1 1 1
2 0 0 2 2 0 0 0 0 0 0 2 0 0 2
2 0 0 2 2 0 0 0 0 0 0 2 0 0 2
0 0 0 0 0 0 2 0 2 0 0 0 0 0 2
2 0 0 2 0 0 0 0 2 0 0 0 0 0 2
2 0 0 2 0 0 2 0 2 0 0 0 0 0 2
2 0 0 0 0 0 2 0 0 0 0 2 0 0 2
2 0 0 2 0 0 0 0 0 0 0 2 0 0 2
2 0 0 0 0 0 0 0 0 0 0 0 0 0 6
3 3 3 3 3 3 3 3 3 3 3 3 3 3 3